R  999 999


NO .texture/1.xpm
SO .texture/eagle.xpm
WE .texture/grey_stone.xpm
EA .texture/fuhrer.xpm
S  .texture/pillar.xpm
















F 11, 117, 50 
C 168, 41, 194 

1111111111111
1000000000201
1000000002001
1111100200111
     10211111
1111102000001
1001020000001
1001000W00001
100100000001
100100010001
10000001111
10000011 11
11111111
