R 680  480 


NO .texture/.png
SO .texture/.png
WE .texture/.png
EA .texture/.png
S  .texture/.png
















F 220,100,0
C 207,74,123

1111111111111
1000000000201
1000000002001
1111100200111
     1000000211111
1111102000001
1001020000001
1001000W00001
100100000001
100100010001
1000000111111
10000011 11
1111111111111
